C 0 0 1 1 5
C 8 0 3 1 5
C 4 4 0 0 1
C 0 8 4 1 5
C 8 8 2 1 5
